11111111111111111111111111
10000PC1000011CCCC10000001
1C111111111C11C000000000C1
10000000000000000000000001
10000000000000000000000001
10000CC0000000C00000CCCCC1
100000C1000011CCCC10000001
1C111111111C11C000011100C1
100000000000000000000000E1
11111111111111111111111111